#######
#..#.##
#o \..#
# ###.#
#= ...#
#######
