#########
#       #
# ##### #
# #   # #
# ##### #
##=    \#
# ##### #
# #   #%#
# #######
#  ...  #
#########
--
0 2
