##########
#      #=#
#      # #
#  #####o#
#  # o  \#
#  ##### #
#  #   # #
#  ##### #
#   ...  #
##########
--
0 2
