#########
#     # #
#     # #
# #####=#
# #...  #
#%##### #
# #   #o#
# #####\#
# .     #
#########
--
0 2
